NO assets/north_texture.xpm
SO assets/south_texture.xpm
EA assets/east_texture.xpm
WE assets/west_texture.xpm

C 25,25,200
F 255,0,0

11111111111111111
1N000000000000001
10000000000000001
10000000000000001
10000000000000001
10000000000000001
10000000000000001
10000000000000001
10000000100000001
10000000000000001
10000000000000001
10000000000000001
11111111111111111
