NO assets/north_texture.xpm
SO assets/south_texture.xpm
EA assets/east_texture.xpm
WE assets/west_texture.xpm

C 255,200,160
F 122,122,122

1111111111
1110001011
1110000011
1100000011
1100000011
11001N0011
1100000011
1100000011
1100000111
1111111111
