NO assets/north_texture.xpm
SO assets/south_texture.xpm
EA assets/east_texture.xpm
WE assets/west_texture.xpm

C 255,200,160
F 122,122,122

1111111111
1110001011111
1110000000001
1100111000001
11001 1000001
1100111N011111
1100000011
1100000011
1100000111
1111111111
